
								DIVINDADES

Arkron: deus dos mortos, e vilão da história

Waq: o deus da sabedoria

Jit: o deus da força

Kay: o deus da magia

Dax: o deus das sombras

Pak: o deus da bravura


								ALIADOS HEAVEN HILL

Princesa Marjorie: humana, Líder dos aliados da Paz, e comandante de Heaven Hill

General Graves: Orc que comanda a linha de frente

Luda: Elfa que comanda as estratégias

Rako: Draconiano que comanda ataques mágicos, elaborador de poções

Elos: Espectro comandante de ataques sorrateiros

Fridz: Uma Orc com ótimas habilidades mágicas


								
								ALIADOS DE ARKRON

Grakos: Demônio, aliado mais forte     
 
Siko e Brako: Espectros gêmeos, que usam as lâminas de Arkron      (mortos)

Voko: Orc de quatro braços     (morto)

Dargon: Draconiano mestre de magia oculta  (morto)

Luno: Pai de Luda, um Elfo corrompído pela maldição de Arkron      (recuperado)

								

								DISCÍPULOS DE ARKRON

Hiro: Um humano, ex membro de Heaven Hill treinado por Siko e Brako

Burzua: Uma Orc treinada por Voko e Dargon, muita força física e habilidades em necromância

KRito: Um espectro com capacidade de metamorfose, treinado por luno e Dargon



								Gorgi

Uma criatura que é composta por todos elementais, e cada elemento possui uma personalidade 

	py: Fogo, uma personalidade mais engraçada

	Ako: Água, uma personalidade mais calma

	Eji: Terra, uma personalidade mais raivosa

	Suo: Vento, uma perosnalidade misteriosa, que conversa por metáforas



								AMIGOS

Viko: Um elfo medroso

Zibo: Um draconiano corajoso que prefere espadas do que magia


